Awesome|Awesome,Awesmoe,Aewsome,Awemsoe
Spelling|Speeling,Sppeling,Spelling,Speling
Acknowledge|Acknowldege,Acknowledge,Ackonwledge,Acknowledeg
Opportunity|Opportuinty,Oportunity,Oppotrunity,Opportunity
Mistake|Mistake,Misatke,Mitsake,Mistek
Laboratory|Labortory,Laboretory,Laboratory,Laboratary
Experience|Experince,Experiance,Experience,Experienec
Definition|Defination,Definetion,Defenition,Definition
Dictionary|Dictionary,Dictionery,Diktionary,Dicsionary
Synonyms|Synonems,Senonyms,Synonyms,Seynonyms
Vocabulary|Vocabelary,Vocabalary,Vocabulary,Vocabulery
Communication|Communicetion,Communicasion,Communicassion,Communication
Necessary|Necessery,Nacessary,Necassary,Necessary
Guarantee|Guarentee,Guarantee,Gearantee,Guarantie
Category|Catagory,Categery,Cetegory,Category
Reference|Refarence,Referance,Reference,Referrence
Designation|Designition,Designetion,Designation,Designasion
Pronunciation|Pronuntiation,Pronounciation,Pronunciation,Prononciation
Idioms|Ideoms,Idioms,Idiums,Idioums
Grocery|Grocary,Grosery,Grocery,Grucery
Confidence|Confidance,Confedence,Confeedence,Confidence
Appreciate|Appresiate,Appretiate,Appreciate,Apreciate
Definitely|Defenitely,Definetely,Definately,Definitely
Accommodate|Accomodate,Acommodate,Acomodate,Accommodate
Receive|Recieve,Receve,Recive,Receive
Occurred|Ocurred,Occured,Ocured,Occurred
Separate|Seperate,Separete,Sepaarate,Separate
Government|Goverment,Govment,Government,Govenment
Publicly|Publiclly,Publicaly,Publicly,Publicley
Reinvention|Reinvension,Renvention,Reinvenssion,Reinvention
Embarrass|Emberrass,Embarass,Embarras,Embarrass
Intelligence|Inteligence,Intelligance,Intelligence,Intellegence
Neighbour|Neighbor,Neighbur,Neighbaur,Neighbour
Depicts|Depects,Depikts,Depics,Depicts
Language|Lenguage,Language,Languag,Languege